##toki pona translated by hallifiman/mjc9576.

#成就#

ACCOLADES=PANA
Scout=Jan
SCOUT=JAN
???=SONA ALA
r:PEAKS SUMMITTED: (\d+)=Tawa Sewi: $1
You don't have this badge yet!=Sina jo ala e ni pana!
Have a friend escape the island without you.=Jan pona li tawa e sina.
Escape the island in under an hour.=O tawa e nena kepeken tenpo pi wan awa.
Help Bing Bong escape the island.=O pana e jan Pin Pon li tawa e nena.
Climb past the SHORE.=O tawa e POKA TELO.
Climb past the TROPICS.=O tawa e MA LON TELO.
Escape the island without eating any packaged food.=O tawa e nena, sina moku ala e poki moku.
Escape the island after cooking and eating a coconut half, a honeycomb, a yellow winterberry, and an egg.=O tawa e nena tenpo sewi sina seli e moku en kili kiwen suli pakala, tomo pi suwi jelo, kili lete jelo, en waso sin.
Climb past the ALPINE.=O tawa e MA KASI.
Climb past the CALDERA.=O tawa e LUPA.
Eat four different non-toxic mushrooms in a single expedition.=O moku e soko tu tu tawa tenpo wan.
Heal your friends for 100 points of injury in a single expedition.=O misikeke wan ali e ike kipiki tawa tenpo wan.
Reach the PEAK.=O kama e NENA.
Cook 20 meals at campfires.=O seli mute moku lon ilo seli.
Escape the island without ever losing consciousness.=O tawa nena pana ala isipin.
Play the bugle for a capybara.=O kepeken ilo kamala tawa misa suli.
Receive 5 Morale Boosts from campfires.=O lanpan luka Pona tan ilo seli.
Place 10 pitons.=O pana luka luka kiki.
Reach the top of a really big tree.=O sewi sina tawa kili pi suli mute.
Have a 1-on-1 with the Scoutmaster.=Sina lukin... ona.
Restore 200 total poison by using items.=Pakala tu ali misikeke ala kepeken ilo.
Eat 5 different berries in a single expedition.=Moku luka kili tawa tenpo wan.
Place 100m of rope in a single expedition.=Kepeken Mita pi wan ali tawa tenpo wan.
Obtain a mystical item.=Jo ijo usawi.
Heal an unconscious friend with an item to save them from death.=Misikeke jan pona kepeken ilo tawa pake moli.
Climb 5000m total.=Tawa sewi Mita pi luka luka luka luka ali.
Escape the island in a solo expedition.=Tawa nena tawa tenpo wan.
Resurrect 3 scouts in a single expedition.=Misikeke jan pi wan tu tawa tenpo wan.
Open 15 luggages in a single expedition.=Open poki pi luka luka luka tawa tenpo wan.
Escape the island without taking fall damage.=Tawa nena taso tawa noka ala.
Read all of Scoutmaster Myres's journal entries.=Lukin jan Mawa lipu ale.
Escape the island without placing anything on the mountain.=Tawa nena taso pana ale.
Climb 50m upwards without touching the ground.=Tawa sewi Mita pi mute mute luka luka taso pilin ala anpa.

##徽章##
Beachcomber Badge=Pana pi  Alasa
BEACHCOMBER BADGE=PANA PI ALASA
Trailblazer Badge=Pana pi Mama
TRAILBLAZER BADGE=PANA PI MAMA
Alpinist Badge=Pana pi Jan ni Tawa e sewi
ALPINIST BADGE=PANA PI JAN NI TAWA E SEWI
Volcanology Badge=Pana pi Jan ni Tokana e Nena seli
VOLCANOLOGY BADGE=PANA PI JAN NI TOKANA E NENA SELI
Peak Badge=Pana pi Nena
PEAK BADGE=PANA PI NENA
Participation Badge=Pana pi Sina Lukin la Tenpo Pini
PARTICIPATION BADGE=PANA PI SINA LUKIN LA TENPO PINI
Esoterica Badge=Pana Tokana
ESOTERICA BADGE=PANA TOKANA
Clutch Badge=Pana ike
CLUTCH BADGE=PANA IKE
First Aid Badge=Pana Misikeke
FIRST AID BADGE=PANA MISIKEKE
Happy Camper Badge=Jan pilin pona
HAPPY CAMPER BADGE=JAN PILIN PONA
Emergency Preparedness Badge=Pana pi Pali e Misikeke
EMERGENCY PREPAREDNESS BADGE=PANA PI PALI E MISIKEKE
Plunderer Badge=Pana li Lanpan utala
PLUNDERER BADGE=PANA LI LANPAN UTALA
High Altitude Badge=Pana sewi
HIGH ALTITUDE BADGE=PANA SEWI
Foraging Badge=Pana Lanpan
FORAGING BADGE=PANA LANPAN
Arborist Badge=Pana la Jan li misikeke e kili
ARBORIST BADGE=PANA LA JAN LI MISIKEKE KILI
Endurance Badge=Pana Awen
ENDURANCE BADGE=PANA AWEN
Mentorship Badge=Pana Tawa
MENTORSHIP BADGE=PANA TAWA
Cooking Badge=Pana Seli
COOKING BADGE=PANA SELI
Animal Serenading Badge=Pana la Musi e Soweli
ANIMAL SERENADING BADGE=PANA LA MUSI E SOWELI
Toxicology Badge=Pana la Misikeke ike
TOXICOLOGY BADGE=PANA LA MISIKEKE IKE
Bouldering Badge=Pana la Kama sewi e Kiwen
BOULDERING BADGE=PANA LA KAMA SEWI E KIWEN
Mycology Badge=Pana la Jan ni Tokana e Soko
MYCOLOGY BADGE=PANA LA JAN NI TOKANA E SOKO
Knot Tying Badge=Pana la Pali e Aka 
KNOT TYING BADGE=PANA LA PALI E AKA
Survivalist Badge=Pana la Jan ni Moli ala
SURVIVALIST BADGE=PANA LA JAN NI MOLI ALA
Bing Bong Badge=Pana Jan Pin Pon
BING BONG BADGE=PANA JAN PIN PON
Lone Wolf Badge=Pana wan
LONE WOLF BADGE=PANA WAN
Speed Climber Badge=Pana la Tawa sewi wiki
SPEED CLIMBER BADGE=PANA LA TAWA SEWI WIKI
Balloon Badge=Pana la sike kon
BALLOON BADGE=PANA LA SIKE KON
Naturalist Badge=Pana la Jan ni Tokana e Ma
NATURALIST BADGE=PANA LA JAN NI TOKANA E MA
Leave No Trace Badge=Pana la Sina Lon ala
LEAVE NO TRACE BADGE=PANA LA SINA LON ALA
Gourmand Badge=Pana Moku
GOURMAND BADGE=PANA MOKU
Bookworm Badge=Pana la Lukin e Lipu
BOOKWORM BADGE=PANA LA LUKIN E LIPU

##階級##
Tadpole Scout=Jan Sin
TADPOLE SCOUT=JAN SIN
Rabbit Scout=Jan Wiki
RABBIT SCOUT=JAN WIKI
Raccoon Scout=Jan Kijetesantakalu
RACCOON SCOUT=JAN KIJETESANTAKALU
Mule Scout=Jan Soweli
MULE SCOUT=JAN SOWELI
Kangaroo Scout=Jan Oselija
KANGAROO SCOUT=JAN OSELIJA
Owl Scout=Jan Waso
OWL SCOUT=JAN WASO
Wolf Scout=Jan Soweli alasa
WOLF SCOUT=JAN SOWELI ALASA
Goat Scout=Jan pona
GOAT SCOUT=JAN PONA
