##keys in Item.txt was origin from team RTLC, zh-tw translate by Voc-夜芷冰

#containers#
Luggage=Poki
LUGGAGE=POKI
Big Luggage=Poki Suli
BIG LUGGAGE=POKI SULI
Explorer's Luggage=Jan Tawa Poki
EXPLORER'S LUGGAGE=JAN TAWA POKI
Ancient Luggage=Poki Majuna
ANCIENT LUGGAGE=POKI MAJUNA
Chain=Linja Kiwen
CHAIN=LINJA KIWEN
Vine=Linja Kasi
VINE=LINJA KASI

#items#
Bing Bong=Pin Pon
BING BONG=Pin Pon
Conch=Selo Kiwen
CONCH=SELO KIWEN
Backpack=Poki Monsi
BACKPACK=POKI MONSI
Granola Bar=Kili Palisa
GRANOLA BAR=KILI PALISA
Trail Mix=Moku Nasa
TRAIL MIX=MOKU NASA
Lantern=Ilo Seli
LANTERN=ILO SELI
Bugle=Ilo Kalama
BUGLE=ILO KALAMA
Compass=Ilo Nasin
COMPASS=ILO NASIN
Coconut=Kili Kiwen Suli
COCONUT=KILI KIWEN SULI
Coconut Half=Kili Kiwen Kipisi
COCONUT HALF=KILI KIWEN KIPISI
anti-rope spool=ala pi linja kulupu
ANTI-ROPE SPOOL=ALA PI LINJA KULUPU
anti-rope=ala linja
ANTI-ROPE=ALA LINJA
rope spool=linja kulupu
ROPE SPOOL=LINJA KULUPU
Energy Drink=Moku Telo Pika
ENERGY DRINK=MOKU TELO PIKA
First Aid Kit=Misikeke Suli
FIRST AID KIT=MISIKEKE SULI
Bandages=Misikeke Lili
BANDAGES=MISIKEKE LILI
Bugle Shroom=Soko Monsuta
BUGLE SHROOM=SOKO MONSUTA
Cluster Shroom=Soko Moli Kulupu
CLUSTER SHROOM=SOKO MOLI KULUPU
Button Shroom=Nena Soko
BUTTON SHROOM=NENA SOKO
Chubby Shroom=Soko Suli
CHUBBY SHROOM=SOKO SULI
Weird Shroom=Soko Nasa
WEIRD SHROOM=SOKO NASA
Airline Food=Moku Tan Ilo Ma Pi Tawa Waso
AIRLINE FOOD=MOKU TAN ILO MA PI TAWA WASO
Big Lollipop=Moku Suli
BIG LOLLIPOP=MOKU SULI
Marshmallow=Moku Puwa
MARSHMALLOW=MOKU PUWA
Faerie Lantern=Ilo Seli Usawi
FAERIE LANTERN=ILO SELI USAWI
Medicinal Root=Kasi Misikeke
MEDICINAL ROOT=KASI MISIKEKE
Pirate's Compass=Jan pi Lanpan Telo Ilo Nasin
PIRATE'S COMPASS=JAN PI LANPAN TELO ILO NASIN
piton=kiki
Piton=kiki
PITON=KIKI
Scout Cookies=Moku Suwi
SCOUT COOKIES=MOKU SUWI
Sports Drink=Musi Utala Moku Telo
SPORTS DRINK=MUSI UTALA MOKU TELO
rope cannon=linja ilo moli
ROPE CANNON=LINJA ILO MOLI
anti-rope cannon=ala linja ilo moli
ANTI-ROPE CANNON=ALA LINJO ILO MOLI
Blowgun=Ilo Moli
BLOWGUN=ILO MOLI
Chain Launcher=linja kiwen ilo moli
CHAIN LAUNCHER=LINJA KIWEN ILO MOLI
Tick=Pipi
TICK=PIPI
Heat Pack=Ilo Seli
HEAT PACK=ILO SELI
Big Egg=Waso pi Sin Suli
BIG EGG=WASO PI SIN SULI
Egg=Waso Sin
EGG=WASO SIN
Beehive=Tomo Pipi
BEEHIVE=TOMO PIPI
Honeycomb=Tomo pi Suwi Jelo
HONEYCOMB=TOMO PI SUWI JELO
Shelf Fungus=Supa Soko
SHELF FUNGUS=SUPA SOKO
Remedy Fungus=Misikeke Soko
REMEDY FUNGUS=MISIKEKE SOTO
Bounce Fungus=Tawa Soto
BOUNCE FUNGUS=TAWA SOTO
Cure-All=Misikeke Ale
CURE-ALL=MISIKEKE ALE
Binoculars= Ilo Lukin
BINOCULARS=ILO LUKIN
Seagull Flag=Waso Len
SEAGULL FLAG=WASO LEN
LOC: NAME_SEAGULL FLAG=WASO LEN
Turtle Flag=Akesi Kiwen Len
TURTLE FLAG=AKESI KIWEN LEN
LOC: NAME_TURTLE FLAG=AKESI KIWEN LEN
Cursed Skull=Kiwen Walo Lawa Ike
CURSED SKULL=KIWEN WALO LAWA IKE
Pandora's Lunchbox=Panola Moku Poki
PANDORA'S LUNCHBOX=PANOLA MOKU POKI
Scout Effigy=Jan Tomo
SCOUT EFFIGY=JAN TOMO
Scoutmaster's Bugle=Jan Lawa Ilo Kalama
SCOUTMASTER'S BUGLE=JAN LAWA ILO KALAMA
Warp Compass=Tawa Wiki Ilo Nasin
WARP COMPASS=TAWA WIKI ILO NASIN
Scroll=Lipu
SCROLL=LIPU
Stick=Palisa
STICK=PALISA
Stone=Kiwen
STONE=KIWEN
Megaphone=Ilo pi Kamala WAWA
MEGAPHONE=ILO PI KAMALA WAWA
Berrynana Peel=Kili Selo
BERRYNANA PEEL=KILI SELO
Scorchberry=Kili Seli
SCORCHBERRY=KILI SELI
Napberry=Kili Lape
NAPBERRY=KILI LAPE
Antidote=Misikeke
ANTIDOTE=MISIKEKE
Bugle of Friendship=Jan Pona Ilo Kalama
BUGLE OF FRIENDSHIP=Jan Pona Ilo Kalama
Portable Stove=Ilo Seli Tawa
PORTABLE STOVE=ILO SELI TAWA
Guidebook=Kulupu Lipu Pona
GUIDEBOOK=KULUPU LIPU PONA
Flare=Palisa Seli
FLARE=PALISA SELI
Magic Bean=Kili Usawi
MAGIC BEAN=KILI USAWI
Frisbee=Lipu Jete
FRISBEE=LIPU JETE
LOC: NAME_FRISBEE=LIPU JETE
Parasol=Len
PARASOL=LEN
LOC: NAME_PARASOL=LEN
Cactus Ball=Kili Kiki Sike
CACTUS BALL=KILI KIKI SIKE
LOC: NAME_CACTUS BALL=KILI KIKI SIKE
Aloe Vera=Kili Pi Seli Ala
ALOE VERA=KILI PI SELI ALA
Balloon=Poki Kon
BALLOON=POKI KON
Dynamite=Ilo pi Wawa Utala 
DYNAMITE=ILO PI WAWA UTALA
LOC: NAME_DYNAMITE=ILO PI WAWA UTALA
Sunscreen=Suno Len
SUNSCREEN=SUNO LEN

##berries##
Green Crispberry=Kili Kulaso
GREEN CRISPBERRY=KILI KULASO
Red Crispberry=Kili Loje
RED CRISPBERRY=KILI LOJE
Yellow Crispberry=Kili Jelo
YELLOW CRISPBERRY=KILI JELO
Purple Crispberry=Kili Unu
PURPLE CRISPBERRY=KILI UNU
Black Crispberry=Kili Pimeja
BLACK CRISPBERRY=KILI PIMEJA
Blue Crispberry=Kili Pulaso
BLUE CRISPBERRY=KILI PULASO
Pink Crispberry=Kili Masenta
PINK CRISPBERRY=KILI MASENTA
Brown Crispberry=Kili Kapesi
BROWN CRISPBERRY=KILI KAPESI
Orange Crispberry=Kili Nalanja
ORANGE CRISPBERRY=KILI NALANJA
Green Kingberry=Kili Lawa Kulaso
GREEN KINGBERRY=KILI LAWA KULASO
Red Kingberry=Kili Lawa Loje
RED KINGBERRY=KILI LAWA LOJE
Yellow Kingberry=Kili Lawa Jelo
YELLOW KINGBERRY=KILI LAWA JELO
Purple Kingberry=Kili Lawa Unu
PURPLE KINGBERRY=KILI LAWA UNU
Black Kingberry=Kili Lawa Pimeja
BLACK KINGBERRY=KILI LAWA PIMEJA
Blue Kingberry=Kili Lawa Pulaso
BLUE KINGBERRY=KILI LAWA PULASO
Pink Kingberry=Kili Lawa Masenta
PINK KINGBERRY=KILI LAWA MASENTA
Brown Kingberry=Kili Lawa Kapesi
BROWN KINGBERRY=KILI LAWA KAPESI
Orange Kingberry=Kili Lawa Nalanja
ORANGE KINGBERRY=KILI LAWA NALANJA
Green Clusterberry=Kili Kulupu Kulaso
GREEN CLUSTERBERRY=KILI KULUPU KULASO
Red Clusterberry=Kili Kulupu Loje
RED CLUSTERBERRY=KILI KULUPU LOJE
Yellow Clusterberry=Kili Kulupu Jelo
YELLOW CLUSTERBERRY=KILI KULUPU JELO
Purple Clusterberry=Kili Kulupu Unu
PURPLE CLUSTERBERRY=KILI KULUPU UNU
Black Clusterberry=Kili Kulupu Pimeja
BLACK CLUSTERBERRY=KILI KULUPU PIMEJA
Blue Clusterberry=Kili Kulupu Pulaso
BLUE CLUSTERBERRY=KILI KULUPU PULASO
Pink Clusterberry=Kili Kulupu Masenta
PINK CLUSTERBERRY=KILI KULUPU MASENTA
Brown Clusterberry=Kili Kulupu Kapesi
BROWN CLUSTERBERRY=KILI KULUPU KAPESI
Orange Clusterberry=Kili Kulupu Nalanja
ORANGE CLUSTERBERRY=KILI KULUPU NALANJA
Green Winterberry=KILI LETE KULASO
GREEN WINTERBERRY=綠色冬莓
Red Winterberry=Kili Lete Loje
RED WINTERBERRY=KILI LETE LOJE
Yellow Winterberry=Kili Lete Jelo
YELLOW WINTERBERRY=KILI LETE JELO
Purple Winterberry=Kili Lete Unu
PURPLE WINTERBERRY=KILI LETE UNU
Black Winterberry=Kili Lete Pimeja
BLACK WINTERBERRY=KILI LETE PIMEJA
Blue Winterberry=Kili Lete Pulaso
BLUE WINTERBERRY=KILI LETE PULASO
Pink Winterberry=Kili Lete Masenta
PINK WINTERBERRY=KILI LETE MASENTA
Brown Winterberry=Kili Lete Kapesi
BROWN WINTERBERRY=KILI LETE KAPESI
Orange Winterberry=Kili Lete Nalanja
ORANGE WINTERBERRY=KILI LETE NALANJA
Green Berrynana=Kili Suli Kulaso
GREEN BERRYNANA=KILI SULI KULASO
Red Berrynana=Kili Suli Loje
RED BERRYNANA=KILI SULI LOJE
Yellow Berrynana=Kili Suli Jelo
YELLOW BERRYNANA=KILI SULI JELO
Purple Berrynana=Kili Suli Unu
PURPLE BERRYNANA=KILI SULI UNU
Black Berrynana=Kili Suli Pimeja
BLACK BERRYNANA=KILI SULI PIMEJA
Blue Berrynana=Kili Suli Pulaso
BLUE BERRYNANA=KILI SULI PULASO
Pink Berrynana=Kili Suli Masenta
PINK BERRYNANA=KILI SULI MASENTA
Brown Berrynana=Kili Suli Kapesi
BROWN BERRYNANA=KILI SULI KAPESI
Orange Berrynana=Kili Suli Nalanja
ORANGE BERRYNANA=KILI SULI NALANJA
Prickleberry=Kili Kiki
PRICKLEBERRY=KILI KIKI
LOC: NAME_PRICKLEBERRY=KILI KIKI
Red Prickleberry=Kili Kiki Loje
RED PRICKLEBERRY=KILI KIKI LOJE