##keys in Settings.txt was origin from team RTLC, zh-tw translate by Voc-夜芷冰

#general
GENERAL=ALE
BACK=O PINI

LANGUAGE=TOKI
English=Toki Pona
FIELD OF VIEW=SUPA LUKIN
CLIMBING EXTRA FIELD OF VIEW=SUPA LUKIN MUTE TAN TAWA SEWI
MOUSE SENSITIVITY=ILO LUKA PIKA WIKI
CONTROLLER SENSITIVITY=ILO LAWA PIKA WIKI
CONTROLLER ICONS=NENA SITELEN
AUTO=PALI JAN
r:"^STYLE (.+)$"=NASIN $1
INVERT Y=O ANTE E Y NASIN
INVERT X=O ANTE E X NASIN
REDUCE CAMERA BOBBING=LUKIN PIKA TAWA ALA

OFF=ALA
ON=LON

LOBBY MODE=TOMO NASIN
FRIENDS=JAN PONA
INVITE ONLY=LIPU TASO


#Graphics#
GRAPHICS=LUKIN

WINDOW MODE=LUPA PIKA NASIN
FULLSCREEN=LUKIN PIKA ALE
WINDOWED=LUPA PIKA
WINDOWED FULLSCREEN=LUKIN ALE LI LUPA PIKA

MAX FRAMERATE=SULI SITELEN WIKI

VSYNC=SEWI/ANPA AWEN
NONE=ALA
ENABLED=LON

RENDER SCALE=SITELEN ENKO
NATIVE=LANPAN
HIGH=SULI
MEDIUM=MESO
LOW=LILI

SHADOW DISTANCE=PIMEJA ENKO
OFF=ALA

WORLD QUALITY=ALE PONA
AMBIENT OCCLUSION=IJO LEN LUKIN ALA
RESOLUTION=LUKIN PIKA ENKO


#Audio#
AUDIO=KALAMA

MICROPHONE=ILO KAMALA
MICROPHONE MODE=ILO KAMALA NASIN
VOICE ACTIVATION=KAMALA PALI
PUSH TO TALK [V]=ILO WAWA PALI [V]
PUSH TO TALK=ILO WAWA PALI
PUSH TO MUTE=ILO WAWA PAKALA

MASTER VOLUME=ALE KAMALA WAWA
MUSIC VOLUME=KAMALA MUSI WAWA
SFX VOLUME=JAN ALA KAMALA WAWA
VOICES VOLUME=KAMALA UTA WAWA